{
    "p": "PP",
    "b": "PP",
    "m": "PP",
    "f": "FF",
    "v": "FF",
    "θ": "TH",
    "ð": "TH",
    "t": "DD",
    "d": "DD",
    "s": "SS",
    "z": "SS",
    "ʃ": "SH",
    "ʒ": "SH",
    "ʧ": "CH",
    "ʤ": "CH",
    "k": "KK",
    "g": "KK",
    "ŋ": "NN",
    "n": "NN",
    "l": "NN",
    "r": "RR",
    "j": "EE",
    "h": "HH",
    "i": "EE",
    "ɪ": "IH",
    "e": "EH",
    "ɛ": "EH",
    "æ": "AA",
    "ɑ": "AA",
    "ʌ": "AH",
    "ɔ": "AO",
    "o": "AO",
    "u": "OO",
    "ʊ": "UH",
    "ə": "AX",
    "w": "WW",
    "sil": "sil",
    "": "sil"
  }
  